F 220,100,0
NO images/no.png

WE images/we.png


SO images/so.png


EA images/ea.png
C 220,100,110

        1111111111111111111111111
        1000000000110000000000001
        1011000001110000000000001
        1001000000000000000000001
111111111011000001110000000000001
100000000011000001110111111111111
11110111111111011100000010001
10110111111111011101010010001
11000000110101011100000010001
10000000000000001100000010001
1000000S0000000011010100000011
1100000111010101111101100010111
1111011101110101 1011110100011
11111111 1111111 111111111111
