NO imgs/cls.png
SO imgs/bls.png
WE imgs/grs.png
EA imgs/mss.png

F 220,100,0
C 225,30,0

1111111
1010001
1000001
1000001
1000001
1000001
1000001
1000001
1000001
1011101
1000001
1000001
1111111