F 100,100,0
NO images/no.png

WE images/we.png


SO images/so.png

EA images/ea.png


C 0,100,0


                          11111111111
                          10000000001
1111111111111111111111111 10000010001
1000000000000000010000001 10000000001
1000111111110000010000001110111110001
10001      100000111111000011  100001
10001111111100000100000011111  110001
1000000000000000000000001       10001
1111111111111111111111101       11111
                      101
       111111111111   101111111
       1W0000000001   10000000111
       10000111110111110000000001
       111111   10000000000000111
                111111111111111