1111111
1000001
1001001
1001001
1001001
1111001
1000001
1111111
