F 100,100,0
NO images/no.png

WE images/we.png


SO images/so.png

EA images/ea.png


C 0,100,0


1111111
1000001
1001001
1001001
1001001
1011001
10000W1
1111111
