F 135,206,250
NO imgs/bls.png
WE imgs/cls.png
SO imgs/grs.png
EA imgs/mss.png
C 100,128,200


1111111
1000001
1001001
10000N1
1111111
