F 135,206,250
NO images/no.png
WE images/we.png
SO images/so.png
EA images/ea.png
C 250,128,114


1111111
1000001
1001001
10000N1
1111111
